##############
E..........#.G
#..###.....#..
#..........C..
##C###....####
..............
.T............
..............