##############
E....F.....#..
#..###.....#..
#...?......C..
##C###....####
M.............
.T............
............G.