##############
E.....?....#..
#..###.....#..
#.....?....C..
##C###....####
..............
.T............
............G.